XXXXXXXXXXXX
X     H    X
X X XXXXXXXX
X X X   X  X
X X X XXX XX
X*X F X    X
X XXX*X XXXX
XF   X X   X
XXXXXXXXXXXX
